

R 640 480

C  100, 050, 33
F  100, 0, 33

NO  ./textures/wood.xpm
 SO  ./textures/brick.xpm 
 EA   ./textures/glowstone.xpm
 WE    ./textures/greystone.xpm
 S     ./textures/barrel.xpm
 
        1111111111111111111111111
        1000000001100000020000001
        1011000001110000000000001
        100100000000202000N202001
111111111011000001110000002000001
100000000011000111110111110111111
11110111111111010000000010011
11110111111111010101010010001
11010101010101010000000010001
10000000000000000001010000001
1001010101010100110001101000111111
1101010111010111111101111000000001
11110111 110101 101111000001111111
11111111 111111 11111111111111